//MAP CONVERTED BY dmm2tgm.py THIS HEADER COMMENT PREVENTS RECONVERSION, DO NOT REMOVE
"a" = (
/turf/open/floor/stone{
	armor = 100000;
	name = "strong stone brick floor"
	},
/area/space)
"c" = (
/obj/structure/bonfire/prelit,
/turf/open/floor/grass,
/area/space)
"d" = (
/obj/machinery/power/emitter/energycannon/magical{
	dir = 4;
	color = #808080;
	name = " fire frog statue";
	projectile_type = /obj/projectile/magic/fireball
	},
/turf/open/floor/stone{
	armor = 100000;
	name = "strong stone brick floor"
	},
/area/space)
"g" = (
/obj/structure/healingfountain,
/turf/open/floor/grass,
/area/space)
"k" = (
/turf/open/floor/stone,
/area/space)
"o" = (
/turf/closed/indestructible/iron{
	desc = "A wall with tough iron plating. It seems to be enchanted.";
	name = "Enchanted iron wall"
	},
/area/space)
"q" = (
/turf/closed/indestructible/paper,
/area/space)
"s" = (
/obj/structure/railing/corner{
	dir = 1
	},
/turf/open/floor/stone{
	armor = 100000;
	name = "strong stone brick floor"
	},
/area/space)
"u" = (
/obj/effect/decal/cleanable/oil/slippery,
/turf/open/floor/stone{
	armor = 100000;
	name = "strong stone brick floor"
	},
/area/space)
"v" = (
/obj/structure/railing/corner{
	dir = 8
	},
/turf/open/floor/stone{
	armor = 100000;
	name = "strong stone brick floor"
	},
/area/space)
"C" = (
/obj/structure/fluff/paper/stack,
/turf/open/indestructible/paper,
/area/space)
"D" = (
/obj/machinery/gateway/away,
/turf/open/floor/stone{
	armor = 100000;
	name = "strong stone brick floor"
	},
/area/space)
"G" = (
/turf/closed/indestructible/iron,
/area/space)
"H" = (
/turf/open/floor/grass,
/area/space)
"I" = (
/obj/structure/fermenting_barrel/gunpowder,
/obj/effect/decal/cleanable/oil/slippery,
/turf/open/floor/stone{
	armor = 100000;
	name = "strong stone brick floor"
	},
/area/space)
"R" = (
/turf/open/indestructible/paper,
/area/space)
"S" = (
/obj/structure/railing{
	dir = 8
	},
/turf/open/floor/stone{
	armor = 100000;
	name = "strong stone brick floor"
	},
/area/space)
"U" = (
/turf/open/chasm,
/area/space)

(1,1,1) = {"
o
o
o
o
o
o
o
o
o
o
o
o
o
o
o
o
o
o
o
o
o
o
o
o
o
o
o
o
o
o
o
o
o
o
o
o
o
o
o
o
o
o
o
o
o
o
o
o
o
o
o
o
o
o
o
o
o
o
o
o
o
o
o
o
o
o
o
o
o
o
o
o
o
o
o
o
o
o
o
o
o
o
o
o
o
o
o
o
o
o
o
o
o
o
o
o
o
o
o
o
o
o
o
o
o
o
o
o
o
o
o
o
o
o
o
"}
(2,1,1) = {"
o
o
o
o
o
o
o
o
o
o
o
o
o
o
o
o
o
o
o
o
o
o
o
o
o
o
o
a
a
a
o
a
a
a
o
a
a
a
a
a
a
a
a
a
o
a
a
a
o
a
a
o
a
a
o
a
o
a
a
a
a
a
a
a
a
a
a
a
a
a
G
a
a
a
a
a
a
a
a
a
a
a
a
a
a
a
a
a
a
a
a
a
a
a
a
a
G
G
G
a
a
a
G
G
o
a
a
a
o
a
a
a
a
a
o
"}
(3,1,1) = {"
o
q
q
q
q
q
q
q
q
q
q
q
q
q
o
o
o
o
o
o
o
o
o
o
o
o
o
a
o
a
o
a
o
a
o
a
o
a
o
a
o
o
o
o
o
a
a
a
o
o
a
a
a
o
o
a
o
a
a
a
a
a
a
a
G
G
G
G
G
a
G
a
G
a
o
o
o
o
G
a
a
a
a
a
G
a
G
a
G
G
G
G
G
G
G
a
G
G
a
a
a
a
a
G
o
a
o
a
o
a
a
a
a
a
o
"}
(4,1,1) = {"
o
q
R
R
C
R
R
R
R
R
R
R
R
q
o
o
o
o
o
o
o
o
o
o
o
o
o
a
o
a
a
a
o
a
o
a
o
a
o
a
o
a
a
a
a
a
a
a
a
a
a
a
a
a
a
a
o
a
a
u
I
u
a
a
G
G
G
G
G
a
a
a
G
a
o
a
a
a
G
a
a
a
a
a
G
a
G
a
G
a
a
a
a
a
G
a
a
a
a
a
a
a
a
a
a
a
o
a
o
a
a
a
a
a
o
"}
(5,1,1) = {"
o
q
R
R
q
R
R
R
R
C
q
R
R
q
o
o
o
o
o
o
o
o
o
o
o
o
o
o
o
o
o
a
o
a
o
a
o
a
o
a
o
a
a
a
o
o
o
o
o
o
a
a
a
o
o
a
o
a
a
I
I
I
a
a
G
G
G
G
G
a
a
a
G
a
o
a
a
a
G
a
a
a
a
a
G
a
G
a
G
a
a
a
G
a
G
G
G
a
a
a
a
a
a
a
o
o
o
a
o
a
o
o
o
a
o
"}
(6,1,1) = {"
o
q
R
q
q
R
R
R
R
R
q
q
R
q
o
o
o
o
o
H
H
H
o
o
o
k
k
k
k
k
o
a
o
a
a
a
o
a
o
a
o
a
a
a
a
a
a
a
o
a
a
o
a
a
o
a
o
a
a
a
I
u
a
a
a
a
a
a
G
a
a
a
G
a
G
a
a
a
G
a
a
a
a
a
G
a
G
a
G
a
a
a
G
a
a
a
a
a
a
a
a
a
a
a
a
a
o
a
a
a
o
a
a
a
o
"}
(7,1,1) = {"
o
q
R
R
R
R
R
R
R
R
R
R
R
q
o
o
o
o
c
H
H
H
H
o
o
k
k
k
k
k
o
a
o
o
o
o
o
a
o
o
o
o
o
o
o
o
o
a
o
o
o
o
o
o
o
a
o
a
a
a
a
a
a
a
G
a
a
a
G
a
a
a
G
a
G
a
a
a
G
a
a
a
a
a
G
a
G
G
G
G
G
G
G
a
a
a
G
G
a
a
a
a
a
G
o
a
o
a
o
o
o
a
o
o
o
"}
(8,1,1) = {"
o
q
R
R
R
R
R
C
R
R
R
R
R
q
q
q
H
H
H
H
H
H
H
H
o
k
k
k
k
k
o
a
a
a
a
a
o
a
o
a
a
a
a
a
a
a
o
a
o
a
o
a
a
a
a
a
a
a
a
a
a
a
a
a
G
a
a
a
G
a
a
a
G
a
G
a
a
a
G
a
a
a
a
a
G
a
a
a
a
a
a
a
G
a
a
a
G
G
G
a
a
a
G
G
o
a
o
a
o
a
a
a
a
a
o
"}
(9,1,1) = {"
o
q
R
R
C
R
R
R
R
R
C
R
R
R
R
R
H
H
H
H
g
H
H
H
a
k
k
k
k
k
o
o
o
a
a
a
o
a
o
a
a
a
a
a
o
a
o
a
o
a
o
a
a
a
o
o
o
o
o
o
o
o
o
a
G
a
G
G
G
a
G
G
G
a
G
a
a
a
G
a
a
a
a
a
G
a
G
G
G
G
G
a
G
G
G
G
G
G
G
a
G
G
G
G
o
a
o
a
o
a
o
a
a
a
o
"}
(10,1,1) = {"
o
q
R
R
R
R
R
R
R
R
R
R
R
q
q
q
H
H
H
H
H
H
H
H
o
k
k
k
k
k
a
a
o
a
a
a
o
a
o
a
a
a
a
a
a
a
o
a
o
a
o
a
a
a
o
a
a
a
a
a
a
a
a
a
G
a
G
G
G
a
G
a
a
a
G
a
a
a
G
a
a
a
a
a
G
a
G
a
a
a
G
a
G
a
a
a
a
a
a
a
G
a
a
a
o
a
o
a
o
a
o
a
a
a
o
"}
(11,1,1) = {"
o
q
R
R
R
R
R
R
R
R
R
R
R
q
o
o
o
o
c
H
H
H
H
o
o
k
k
k
k
k
o
a
o
a
a
a
o
a
o
a
a
a
a
a
o
o
o
a
o
a
o
a
a
a
o
a
o
o
o
o
o
o
o
o
o
a
G
G
G
a
G
a
a
a
G
a
a
a
G
a
a
a
a
a
G
a
G
a
a
a
G
a
G
a
a
a
a
a
a
a
G
a
a
a
o
a
o
a
o
o
o
o
o
o
o
"}
(12,1,1) = {"
o
q
R
q
q
R
R
C
R
R
q
q
R
q
o
o
o
o
o
H
H
H
o
o
o
k
k
k
k
k
o
a
o
a
a
a
o
a
o
a
a
a
a
a
o
a
a
a
a
a
o
a
a
a
o
a
a
a
a
a
a
a
a
a
a
a
G
G
G
a
G
a
a
a
G
a
a
a
G
a
a
a
a
a
G
a
a
a
a
a
G
a
G
a
a
a
a
a
a
a
G
a
a
a
o
a
o
a
o
o
H
H
H
o
o
"}
(13,1,1) = {"
o
q
R
R
q
R
R
R
R
R
q
R
R
q
o
o
o
o
o
o
o
o
o
o
o
o
o
o
o
a
o
a
o
a
a
a
o
a
o
a
a
a
a
a
o
a
a
a
o
a
o
a
a
a
o
o
o
o
o
a
a
a
a
a
a
a
G
G
G
a
G
a
a
a
G
a
a
a
G
G
G
G
G
G
G
G
G
G
G
G
G
a
G
a
a
a
a
a
a
a
G
a
a
a
o
a
o
a
o
H
H
H
H
H
o
"}
(14,1,1) = {"
o
q
R
R
R
R
R
R
R
R
R
R
R
q
o
o
o
o
o
o
o
o
o
o
o
o
o
a
a
a
o
a
o
a
a
a
o
a
a
a
a
a
a
a
a
a
a
a
o
a
o
a
a
a
a
a
a
a
o
a
a
a
a
a
a
a
G
G
G
a
G
a
a
a
a
a
a
a
G
a
a
a
G
G
H
H
H
G
G
a
a
a
G
a
a
a
a
a
a
a
a
a
a
a
o
a
o
a
a
H
H
c
H
H
o
"}
(15,1,1) = {"
o
q
q
q
q
q
q
q
q
q
q
q
q
q
o
o
o
o
o
o
o
o
o
o
o
o
o
a
a
a
o
a
o
o
o
a
o
o
o
o
o
o
o
o
o
o
o
o
o
o
o
o
o
o
o
o
o
a
o
a
a
a
a
a
a
a
G
G
G
a
G
a
a
a
G
a
a
a
G
a
G
a
G
H
H
H
H
H
G
a
G
G
G
G
G
G
G
G
G
G
G
a
a
a
o
o
o
a
o
H
H
H
H
H
o
"}
(16,1,1) = {"
o
o
o
o
o
o
o
o
o
o
o
o
o
o
o
o
o
o
o
o
o
o
o
o
o
o
o
a
a
a
o
a
a
a
a
a
a
a
a
a
a
o
o
a
a
a
o
a
a
a
a
a
a
a
a
a
a
a
o
a
a
a
a
a
a
a
G
a
a
a
G
a
a
a
G
a
a
a
G
a
G
a
a
H
H
c
H
H
G
a
a
a
a
a
a
a
a
a
a
a
G
a
a
a
a
a
o
a
o
o
H
H
H
o
o
"}
(17,1,1) = {"
o
o
o
o
o
o
o
o
o
o
o
o
o
o
o
o
o
o
o
o
o
o
o
o
o
o
o
o
o
a
o
o
o
o
o
o
o
o
o
o
a
o
o
a
a
a
o
a
o
a
a
a
a
a
o
o
o
o
o
a
o
a
o
o
o
o
G
a
G
G
G
G
o
o
o
a
G
G
G
a
G
a
G
H
H
H
H
H
G
a
a
a
a
a
a
a
a
a
a
a
G
a
o
o
o
a
o
a
o
o
o
a
o
o
o
"}
(18,1,1) = {"
o
o
o
o
o
o
o
o
o
o
o
o
o
o
o
o
o
o
o
o
o
o
o
o
o
o
o
a
a
a
o
a
a
a
a
a
a
o
o
o
a
o
o
a
a
a
a
a
o
a
a
a
a
a
o
a
a
a
a
a
o
a
a
a
o
a
a
a
G
a
a
a
a
a
a
a
o
a
a
a
G
a
G
G
H
H
H
G
G
a
a
a
a
a
a
a
a
a
a
a
G
a
a
a
o
a
o
a
o
o
o
a
a
a
o
"}
(19,1,1) = {"
o
o
o
o
o
o
o
o
o
o
o
o
o
o
o
o
o
o
o
o
o
o
o
o
o
o
o
a
a
a
o
a
a
a
a
a
a
o
o
H
H
H
o
o
o
o
o
o
o
a
a
a
a
a
o
a
a
a
a
a
o
a
o
o
o
a
G
G
G
a
a
a
a
a
a
a
o
a
G
a
G
G
G
G
G
a
G
G
G
G
G
G
G
G
G
G
G
G
G
a
G
a
a
a
o
a
o
a
o
o
o
o
o
a
o
"}
(20,1,1) = {"
o
o
o
o
o
o
o
o
o
o
o
o
o
o
o
o
o
o
o
o
o
o
o
o
o
o
o
a
a
a
o
a
a
a
a
a
a
o
H
H
H
H
H
o
a
a
a
a
o
a
a
a
a
a
a
a
a
a
a
a
o
a
a
a
a
a
G
G
G
a
a
a
a
a
a
a
o
a
G
a
G
a
a
a
a
a
a
a
G
a
a
a
a
a
a
a
G
G
G
a
G
a
a
a
o
a
a
a
o
a
a
a
a
a
o
"}
(21,1,1) = {"
o
o
o
o
o
o
o
o
o
o
o
o
o
o
o
o
o
o
o
o
o
o
o
o
o
o
o
a
a
a
o
a
a
a
a
a
a
a
H
H
c
H
H
a
a
o
o
a
o
o
o
o
o
o
o
o
o
o
o
o
o
o
o
o
o
a
G
G
G
a
G
G
o
o
o
a
o
a
G
a
G
a
a
a
a
a
a
a
G
a
a
a
a
a
a
a
G
G
G
a
G
a
a
a
o
o
o
o
o
a
D
a
a
a
o
"}
(22,1,1) = {"
o
o
o
o
o
o
o
o
o
o
o
o
o
o
o
o
o
o
o
o
o
o
o
o
o
o
o
a
a
a
a
a
a
a
a
a
a
o
H
H
H
H
H
o
o
a
a
a
o
d
a
d
a
d
a
d
a
d
a
d
a
d
a
d
o
a
a
a
a
a
a
a
o
a
a
a
a
a
G
a
G
a
a
a
a
a
a
a
a
a
a
a
a
a
a
a
a
a
a
a
G
a
a
a
o
o
o
o
o
a
a
a
a
a
o
"}
(23,1,1) = {"
o
o
o
o
o
o
o
o
o
o
o
o
o
o
o
o
o
o
o
o
o
o
o
o
o
o
o
o
o
o
o
a
a
a
a
a
a
o
o
H
H
H
o
o
o
a
o
o
o
U
U
U
U
U
U
U
U
U
U
U
U
U
U
U
G
G
G
G
G
a
a
a
o
a
a
a
a
a
G
a
G
G
G
a
G
G
G
G
G
a
a
a
a
a
a
a
G
G
G
G
G
a
G
G
o
o
o
o
o
o
o
o
o
o
o
"}
(24,1,1) = {"
o
o
o
o
o
o
o
o
o
o
o
o
o
o
o
o
o
o
o
o
o
o
o
o
o
o
o
o
o
o
o
a
a
a
a
a
a
o
o
o
o
o
o
o
o
a
a
a
v
S
S
S
S
S
S
S
S
S
S
S
S
S
S
S
s
a
a
a
a
a
a
a
a
a
a
a
a
a
G
a
a
a
G
a
a
a
a
a
a
a
a
a
a
a
a
a
G
a
a
a
a
a
a
a
a
a
a
a
a
a
a
a
a
a
o
"}
(25,1,1) = {"
o
o
o
o
o
o
o
o
o
o
o
o
o
o
o
o
o
o
o
o
o
o
o
o
o
o
o
o
o
o
o
o
o
o
o
o
o
o
o
o
o
o
o
o
o
o
o
o
o
o
o
o
o
o
o
o
o
o
o
o
o
o
o
o
o
o
o
o
o
o
o
o
o
o
o
o
o
o
o
o
o
o
o
o
o
o
o
o
o
o
o
o
o
o
o
o
o
o
o
o
o
o
o
o
o
o
o
o
o
o
o
o
o
o
o
"}
