//MAP CONVERTED BY dmm2tgm.py THIS HEADER COMMENT PREVENTS RECONVERSION, DO NOT REMOVE
"a" = (
/turf/open/indestructible{
	icon_state = "stone_floor"
	},
/area/space)
"c" = (
/obj/structure/bonfire/prelit,
/turf/open/indestructible{
	icon_state = "stone_floor"
	},
/area/space)
"d" = (
/obj/machinery/power/emitter/energycannon/magical{
	dir = 4;
	color = #808080;
	name = " fire frog statue";
	projectile_type = /obj/projectile/magic/fireball;
	atom_colours = #808080
	},
/turf/open/indestructible{
	icon_state = "stone_floor"
	},
/area/space)
"g" = (
/obj/structure/healingfountain,
/turf/open/indestructible{
	icon_state = "stone_floor"
	},
/area/space)
"o" = (
/turf/closed/indestructible/iron{
	desc = "A wall with tough iron plating. It seems to be enchanted.";
	name = "Enchanted iron wall"
	},
/area/space)
"s" = (
/obj/structure/railing/corner{
	dir = 1
	},
/turf/open/indestructible{
	icon_state = "stone_floor"
	},
/area/space)
"v" = (
/obj/structure/railing/corner{
	dir = 8
	},
/turf/open/indestructible{
	icon_state = "stone_floor"
	},
/area/space)
"D" = (
/obj/machinery/gateway/away,
/turf/open/indestructible{
	icon_state = "stone_floor"
	},
/area/space)
"G" = (
/turf/closed/indestructible/iron,
/area/space)
"N" = (
/obj/machinery/power/emitter/energycannon/magical{
	dir = 4;
	color = #808080;
	name = " fire frog statue";
	projectile_type = /obj/projectile/magic/fireball;
	icon_state = "wabbajack_statue_on";
	atom_colours = #808080
	},
/turf/open/indestructible{
	icon_state = "stone_floor"
	},
/area/space)
"S" = (
/obj/structure/railing{
	dir = 8
	},
/turf/open/indestructible{
	icon_state = "stone_floor"
	},
/area/space)
"U" = (
/turf/open/chasm,
/area/space)

(1,1,1) = {"
o
o
o
o
o
o
o
o
o
o
o
o
o
o
o
o
o
o
o
o
o
o
o
o
o
o
o
o
o
o
o
o
o
o
o
o
o
o
o
o
o
o
o
o
o
o
o
o
o
o
o
o
o
o
o
o
o
o
o
o
o
o
o
o
o
o
o
o
o
o
o
o
o
o
o
o
o
o
o
o
o
o
o
o
o
o
o
o
o
o
o
o
o
o
o
o
o
o
o
o
o
o
o
o
o
o
o
o
o
o
o
o
o
o
o
"}
(2,1,1) = {"
o
o
o
o
o
o
o
o
o
o
o
o
o
o
o
o
o
o
o
o
o
o
o
o
o
o
o
a
a
a
o
a
a
a
o
a
a
a
a
a
a
a
a
a
o
a
a
a
o
a
a
o
a
a
o
a
o
a
a
a
a
a
a
a
a
a
a
a
a
a
G
a
a
a
a
a
a
a
a
a
a
a
a
a
a
a
a
a
a
a
a
a
a
a
a
a
G
G
G
a
a
a
G
G
o
a
a
a
o
a
a
a
a
a
o
"}
(3,1,1) = {"
o
o
o
o
o
o
o
o
o
o
o
o
o
o
o
o
o
o
o
o
o
o
o
o
o
o
o
a
o
a
o
a
o
a
o
a
o
a
o
a
o
o
o
o
o
a
a
a
o
o
a
a
a
o
o
a
o
a
a
a
a
a
a
a
G
G
G
G
G
a
G
a
G
a
o
o
o
o
G
a
a
a
a
a
G
a
G
a
G
G
G
G
G
G
G
a
G
G
a
a
a
a
a
G
o
a
o
a
o
a
a
a
a
a
o
"}
(4,1,1) = {"
o
o
a
a
a
a
a
a
a
a
a
a
a
o
o
o
o
o
o
o
o
o
o
o
o
o
o
a
o
a
a
a
o
a
o
a
o
a
o
a
o
a
a
a
a
a
a
a
a
a
a
a
a
a
a
a
o
a
a
a
a
a
a
a
G
G
G
G
G
a
a
a
G
a
o
a
a
a
G
a
a
a
a
a
G
a
G
a
G
a
a
a
a
a
G
a
a
a
a
a
a
a
a
a
a
a
o
a
o
a
a
a
a
a
o
"}
(5,1,1) = {"
o
o
a
a
o
a
a
a
a
a
o
a
a
o
o
o
o
o
o
o
o
o
o
o
o
o
o
a
o
o
o
a
o
a
o
a
o
a
o
a
o
a
a
a
o
o
o
o
o
o
a
a
a
o
o
a
o
a
a
a
a
a
a
a
G
G
G
G
G
a
a
a
G
a
o
a
a
a
G
a
a
a
a
a
G
a
G
a
G
a
a
a
G
a
G
G
G
a
a
a
a
a
a
a
o
o
o
a
o
a
o
o
o
a
o
"}
(6,1,1) = {"
o
o
a
o
o
a
a
a
a
a
o
o
a
o
o
o
o
o
o
a
a
a
o
o
o
a
a
a
a
a
o
a
o
a
a
a
o
a
o
a
o
a
a
a
a
a
a
a
o
a
a
o
a
a
o
a
o
a
a
a
a
a
a
a
a
a
a
a
G
a
a
a
G
a
G
a
a
a
G
a
a
a
a
a
G
a
G
a
G
a
a
a
G
a
a
a
a
a
a
a
a
a
a
a
a
a
o
a
a
a
o
a
a
a
o
"}
(7,1,1) = {"
o
o
a
a
a
a
a
a
a
a
a
a
a
o
o
o
o
o
c
a
a
a
a
o
o
a
a
a
a
a
o
a
o
o
o
o
o
a
o
o
o
o
o
o
o
o
o
a
o
o
o
o
o
o
o
a
o
a
a
a
a
a
a
a
G
a
a
a
G
a
a
a
G
a
G
a
a
a
G
a
a
a
a
a
G
a
G
G
G
G
G
G
G
a
a
a
G
G
a
a
a
a
a
G
o
a
o
a
o
o
o
a
o
o
o
"}
(8,1,1) = {"
o
o
a
a
a
a
a
a
a
a
a
a
a
o
o
o
a
a
a
a
a
a
a
a
o
a
a
a
a
a
o
a
a
a
a
a
o
a
o
a
a
a
a
a
a
a
o
a
o
a
o
a
a
a
a
a
a
a
a
a
a
a
a
a
G
a
a
a
G
a
a
a
G
a
G
a
a
a
G
a
a
a
a
a
G
a
a
a
a
a
a
a
G
a
a
a
G
G
G
a
a
a
G
G
o
a
o
a
o
a
a
a
a
a
o
"}
(9,1,1) = {"
o
o
a
a
a
a
a
a
a
a
a
a
a
a
a
a
a
a
a
a
g
a
a
a
a
a
a
a
a
a
o
o
o
a
a
a
o
a
o
a
a
a
a
a
o
a
o
a
o
a
o
a
a
a
o
o
o
o
o
o
o
o
o
a
G
a
G
G
G
a
G
G
G
a
G
a
a
a
G
a
a
a
a
a
G
a
G
G
G
G
G
a
G
G
G
G
G
G
G
a
G
G
G
G
o
a
o
a
o
a
o
a
a
a
o
"}
(10,1,1) = {"
o
o
a
a
a
a
a
a
a
a
a
a
a
o
o
o
a
a
a
a
a
a
a
a
o
a
a
a
a
a
a
a
o
a
a
a
o
a
o
a
a
a
a
a
a
a
o
a
o
a
o
a
a
a
o
a
a
a
a
a
a
a
a
a
G
a
G
G
G
a
G
a
a
a
G
a
a
a
G
a
a
a
a
a
G
a
G
a
a
a
G
a
G
a
a
a
a
a
a
a
G
a
a
a
o
a
o
a
o
a
o
a
a
a
o
"}
(11,1,1) = {"
o
o
a
a
a
a
a
a
a
a
a
a
a
o
o
o
o
o
c
a
a
a
a
o
o
a
a
a
a
a
o
a
o
a
a
a
o
a
o
a
a
a
a
a
o
o
o
a
o
a
o
a
a
a
o
a
o
o
o
o
o
o
o
o
o
a
G
G
G
a
G
a
a
a
G
a
a
a
G
a
a
a
a
a
G
a
G
a
a
a
G
a
G
a
a
a
a
a
a
a
G
a
a
a
o
a
o
a
o
o
o
o
o
o
o
"}
(12,1,1) = {"
o
o
a
o
o
a
a
a
a
a
o
o
a
o
o
o
o
o
o
a
a
a
o
o
o
a
a
a
a
a
o
a
o
a
a
a
o
a
o
a
a
a
a
a
o
a
a
a
a
a
o
a
a
a
o
a
a
a
a
a
a
a
a
a
a
a
G
G
G
a
G
a
a
a
G
a
a
a
G
a
a
a
a
a
G
a
a
a
a
a
G
a
G
a
a
a
a
a
a
a
G
a
a
a
o
a
o
a
o
o
a
a
a
o
o
"}
(13,1,1) = {"
o
o
a
a
o
a
a
a
a
a
o
a
a
o
o
o
o
o
o
o
o
o
o
o
o
o
o
o
o
a
o
a
o
a
a
a
o
a
o
a
a
a
a
a
o
a
a
a
o
a
o
a
a
a
o
o
o
o
o
a
a
a
a
a
a
a
G
G
G
a
G
a
a
a
G
a
a
a
G
G
G
G
G
G
G
G
G
G
G
G
G
a
G
a
a
a
a
a
a
a
G
a
a
a
o
a
o
a
o
a
a
a
a
a
o
"}
(14,1,1) = {"
o
o
a
a
a
a
a
a
a
a
a
a
a
o
o
o
o
o
o
o
o
o
o
o
o
o
o
a
a
a
o
a
o
a
a
a
o
a
a
a
a
a
a
a
a
a
a
a
o
a
o
a
a
a
a
a
a
a
o
a
a
a
a
a
a
a
G
G
G
a
G
a
a
a
a
a
a
a
G
a
a
a
G
G
a
a
a
G
G
a
a
a
G
a
a
a
a
a
a
a
a
a
a
a
o
a
o
a
a
a
a
c
a
a
o
"}
(15,1,1) = {"
o
o
o
o
o
o
o
o
o
o
o
o
o
o
o
o
o
o
o
o
o
o
o
o
o
o
o
a
a
a
o
a
o
o
o
a
o
o
o
o
o
o
o
o
o
o
o
o
o
o
o
o
o
o
o
o
o
a
o
a
a
a
a
a
a
a
G
G
G
a
G
a
a
a
G
a
a
a
G
a
G
a
G
a
a
a
a
a
G
a
G
G
G
G
G
G
G
G
G
G
G
a
a
a
o
o
o
a
o
a
a
a
a
a
o
"}
(16,1,1) = {"
o
o
o
o
o
o
o
o
o
o
o
o
o
o
o
o
o
o
o
o
o
o
o
o
o
o
o
a
a
a
o
a
a
a
a
a
a
a
a
a
a
o
o
a
a
a
o
a
a
a
a
a
a
a
a
a
a
a
o
a
a
a
a
a
a
a
G
a
a
a
G
a
a
a
G
a
a
a
G
a
G
a
a
a
a
c
a
a
G
a
a
a
a
a
a
a
a
a
a
a
G
a
a
a
a
a
o
a
o
o
a
a
a
o
o
"}
(17,1,1) = {"
o
o
o
o
o
o
o
o
o
o
o
o
o
o
o
o
o
o
o
o
o
o
o
o
o
o
o
a
o
o
o
o
o
o
o
o
o
o
o
o
a
o
o
a
a
a
o
a
o
a
a
a
a
a
o
o
o
o
o
a
o
a
o
o
o
o
G
a
G
G
G
G
o
o
o
a
G
G
G
a
G
a
G
a
a
a
a
a
G
a
a
a
a
a
a
a
a
a
a
a
G
a
o
o
o
a
o
a
o
o
o
a
o
o
o
"}
(18,1,1) = {"
o
o
o
o
o
o
o
o
o
o
o
o
o
o
o
o
o
o
o
o
o
o
o
o
o
o
o
a
a
a
o
a
a
a
a
a
a
o
o
o
a
o
o
a
a
a
a
a
o
a
a
a
a
a
o
a
a
a
a
a
o
a
a
a
o
a
a
a
G
a
a
a
a
a
a
a
o
a
a
a
G
a
G
G
a
a
a
G
G
a
a
a
a
a
a
a
a
a
a
a
G
a
a
a
o
a
o
a
o
o
o
a
a
a
o
"}
(19,1,1) = {"
o
o
o
o
o
o
o
o
o
o
o
o
o
o
o
o
o
o
o
o
o
o
o
o
o
o
o
a
a
a
o
a
a
a
a
a
a
o
o
a
a
a
o
o
o
o
o
o
o
a
a
a
a
a
o
a
a
a
a
a
o
a
o
o
o
a
G
G
G
a
a
a
a
a
a
a
o
a
G
a
G
G
G
G
G
a
G
G
G
G
G
G
G
G
G
G
G
G
G
a
G
a
a
a
o
a
o
a
o
o
o
o
o
a
o
"}
(20,1,1) = {"
o
o
o
o
o
o
o
o
o
o
o
o
o
o
o
o
o
o
o
o
o
o
o
o
o
o
o
a
a
a
o
a
a
a
a
a
a
o
a
a
a
a
a
o
a
a
a
a
o
a
a
a
a
a
a
a
a
a
a
a
o
a
a
a
a
a
G
G
G
a
a
a
a
a
a
a
o
a
G
a
G
a
a
a
a
a
a
a
G
a
a
a
a
a
a
a
G
G
G
a
G
a
a
a
o
a
a
a
o
a
a
a
a
a
o
"}
(21,1,1) = {"
o
o
o
o
o
o
o
o
o
o
o
o
o
o
o
o
o
o
o
o
o
o
o
o
o
o
o
a
a
a
o
a
a
a
a
a
a
a
a
a
c
a
a
a
a
o
o
a
o
o
o
o
o
o
o
o
o
o
o
o
o
o
o
o
o
a
G
G
G
a
G
G
o
o
o
a
o
a
G
a
G
a
a
a
a
a
a
a
G
a
a
a
a
a
a
a
G
G
G
a
G
a
a
a
o
o
o
o
o
a
D
a
a
a
o
"}
(22,1,1) = {"
o
o
o
o
o
o
o
o
o
o
o
o
o
o
o
o
o
o
o
o
o
o
o
o
o
o
o
a
a
a
a
a
a
a
a
a
a
o
a
a
a
a
a
o
o
a
a
a
o
d
N
d
N
d
N
d
N
d
N
d
N
d
N
d
o
a
a
a
a
a
a
a
o
a
a
a
a
a
G
a
G
a
a
a
a
a
a
a
a
a
a
a
a
a
a
a
a
a
a
a
G
a
a
a
o
o
o
o
o
a
a
a
a
a
o
"}
(23,1,1) = {"
o
o
o
o
o
o
o
o
o
o
o
o
o
o
o
o
o
o
o
o
o
o
o
o
o
o
o
o
o
o
o
a
a
a
a
a
a
o
o
a
a
a
o
o
o
a
o
o
o
U
U
U
U
U
U
U
U
U
U
U
U
U
U
U
G
G
G
G
G
a
a
a
o
a
a
a
a
a
G
a
G
G
G
a
G
G
G
G
G
a
a
a
a
a
a
a
G
G
G
G
G
a
G
G
o
o
o
o
o
o
o
o
o
o
o
"}
(24,1,1) = {"
o
o
o
o
o
o
o
o
o
o
o
o
o
o
o
o
o
o
o
o
o
o
o
o
o
o
o
o
o
o
o
a
a
a
a
a
a
o
o
o
o
o
o
o
o
a
a
a
v
S
S
S
S
S
S
S
S
S
S
S
S
S
S
S
s
a
a
a
a
a
a
a
a
a
a
a
a
a
G
a
a
a
G
a
a
a
a
a
a
a
a
a
a
a
a
a
G
a
a
a
a
a
a
a
a
a
a
a
a
a
a
a
a
a
o
"}
(25,1,1) = {"
o
o
o
o
o
o
o
o
o
o
o
o
o
o
o
o
o
o
o
o
o
o
o
o
o
o
o
o
o
o
o
o
o
o
o
o
o
o
o
o
o
o
o
o
o
o
o
o
o
o
o
o
o
o
o
o
o
o
o
o
o
o
o
o
o
o
o
o
o
o
o
o
o
o
o
o
o
o
o
o
o
o
o
o
o
o
o
o
o
o
o
o
o
o
o
o
o
o
o
o
o
o
o
o
o
o
o
o
o
o
o
o
o
o
o
"}
