//MAP CONVERTED BY dmm2tgm.py THIS HEADER COMMENT PREVENTS RECONVERSION, DO NOT REMOVE
"a" = (
/turf/open/indestructible{
	icon_state = "stone_floor";
	name = "Dungeon Floor"
	},
/area/space)
"c" = (
/obj/structure/bonfire/prelit,
/turf/open/indestructible{
	icon_state = "stone_floor";
	name = "Dungeon Floor"
	},
/area/space)
"g" = (
/obj/structure/healingfountain,
/turf/open/indestructible{
	icon_state = "stone_floor";
	name = "Dungeon Floor"
	},
/area/space)
"k" = (
/mob/living/simple_animal/hostile/retaliate/bat,
/turf/open/indestructible{
	icon_state = "stone_floor";
	name = "Dungeon Floor"
	},
/area/space)
"l" = (
/obj/item/flashlight/flare/torch,
/turf/open/indestructible{
	icon_state = "stone_floor";
	name = "Dungeon Floor"
	},
/area/space)
"o" = (
/turf/closed/indestructible/iron{
	desc = "A wall with tough iron plating. It seems to be enchanted.";
	name = "Enchanted iron wall"
	},
/area/space)
"r" = (
/obj/item/claymore,
/turf/open/indestructible{
	icon_state = "stone_floor";
	name = "Dungeon Floor"
	},
/area/space)
"s" = (
/obj/structure/railing/corner{
	dir = 1
	},
/turf/open/indestructible{
	icon_state = "stone_floor";
	name = "Dungeon Floor"
	},
/area/space)
"t" = (
/obj/machinery/power/emitter/energycannon{
	name = "Dart Trap";
	desc = "A hidden dart trap that is imbeded in the dungeon wall.";
	machine_power_rectifier = 0;
	circuit = null;
	projectile_sound = 'sound/weapons/tap.ogg';
	maximum_fire_delay = 20;
	projectile_type = /obj/projectile/bullet/dart;
	payment_department = null
	},
/turf/open/indestructible{
	icon_state = "stone_floor";
	name = "Dungeon Floor"
	},
/area/space)
"v" = (
/obj/structure/railing/corner{
	dir = 8
	},
/turf/open/indestructible{
	icon_state = "stone_floor";
	name = "Dungeon Floor"
	},
/area/space)
"z" = (
/obj/item/food/cheese/wedge,
/turf/open/indestructible{
	icon_state = "stone_floor";
	name = "Dungeon Floor"
	},
/area/space)
"D" = (
/obj/machinery/gateway/away,
/turf/open/indestructible{
	icon_state = "stone_floor";
	name = "Dungeon Floor"
	},
/area/space)
"G" = (
/turf/closed/indestructible/iron,
/area/space)
"H" = (
/mob/living/simple_animal/hostile/rat,
/turf/open/indestructible{
	icon_state = "stone_floor";
	name = "Dungeon Floor"
	},
/area/space)
"I" = (
/obj/effect/temp_visual/cult/door/unruned,
/turf/open/indestructible{
	icon_state = "stone_floor";
	name = "Dungeon Floor"
	},
/area/space)
"P" = (
/mob/living/simple_animal/hostile/regalrat,
/turf/open/indestructible{
	icon_state = "stone_floor";
	name = "Dungeon Floor"
	},
/area/space)
"Q" = (
/turf/open/space/basic,
/area/space)
"S" = (
/obj/structure/railing{
	dir = 8
	},
/turf/open/indestructible{
	icon_state = "stone_floor";
	name = "Dungeon Floor"
	},
/area/space)
"U" = (
/turf/open/chasm,
/area/space)
"V" = (
/obj/item/food/cheese/wheel,
/obj/item/knife/kitchen,
/turf/open/indestructible{
	icon_state = "stone_floor";
	name = "Dungeon Floor"
	},
/area/space)
"Y" = (
/obj/machinery/door/morgue,
/turf/open/indestructible{
	icon_state = "stone_floor";
	name = "Dungeon Floor"
	},
/area/space)

(1,1,1) = {"
o
o
o
o
o
o
o
o
o
o
o
o
o
o
o
o
o
o
o
o
o
o
o
o
o
o
o
o
o
o
o
o
o
o
o
o
o
o
o
o
o
o
o
o
o
o
o
o
o
o
o
o
o
o
o
o
o
o
o
o
o
o
o
o
o
o
o
o
o
o
o
o
o
o
o
o
o
o
o
o
o
o
o
o
o
o
o
o
o
o
o
o
o
o
o
o
o
o
o
o
o
o
o
o
o
o
o
o
o
o
o
o
o
o
o
"}
(2,1,1) = {"
o
o
o
o
o
o
o
o
o
o
o
o
o
o
o
o
o
o
o
o
o
o
o
o
o
o
o
a
a
a
o
a
a
a
o
a
a
a
a
a
a
a
a
a
o
a
a
a
o
a
a
o
a
a
o
a
o
a
a
a
a
a
a
a
a
a
a
a
a
a
G
a
a
a
a
a
a
a
a
a
a
a
a
a
a
a
a
a
a
a
a
a
a
a
a
a
G
G
G
a
a
a
G
G
o
a
a
a
o
a
H
a
H
a
o
"}
(3,1,1) = {"
o
o
o
o
o
o
o
o
o
o
o
o
o
o
o
o
o
o
o
o
o
o
o
o
o
o
o
a
o
a
o
a
o
a
o
a
o
a
o
a
o
o
o
o
o
a
a
a
o
o
a
a
a
o
o
a
o
a
a
a
a
a
a
a
G
G
G
G
G
a
G
a
G
a
o
o
o
o
G
a
a
a
a
a
G
a
G
a
G
G
G
G
G
G
G
a
G
G
a
a
a
a
a
G
o
a
o
a
o
a
a
a
a
a
o
"}
(4,1,1) = {"
o
o
a
a
a
a
a
a
a
a
a
a
a
o
o
o
o
o
o
o
o
o
o
o
o
o
o
a
o
a
a
a
o
a
o
a
o
a
o
a
o
a
a
a
a
a
a
a
a
a
a
a
a
a
a
a
o
a
a
a
a
a
a
a
G
G
G
G
G
a
a
a
G
a
o
a
a
a
G
a
a
a
a
a
G
a
G
a
G
a
a
a
a
a
G
a
Y
a
a
a
k
a
a
a
Y
a
o
a
o
H
a
H
a
H
o
"}
(5,1,1) = {"
o
o
a
a
o
a
a
a
a
a
o
a
a
o
o
o
o
o
o
o
o
o
o
o
o
o
o
a
o
o
o
a
o
a
o
a
o
a
o
a
o
a
a
a
o
o
o
o
o
o
a
a
a
o
o
a
o
a
a
a
a
a
a
a
G
G
G
G
G
a
a
a
G
a
o
a
a
a
G
a
a
a
a
a
G
a
G
a
G
a
a
a
G
a
G
G
G
a
a
k
k
k
a
a
o
o
o
a
o
a
o
o
o
Y
o
"}
(6,1,1) = {"
o
o
a
o
o
a
a
a
a
a
o
o
a
o
o
o
o
o
o
a
a
a
o
o
o
a
a
a
a
a
o
a
o
a
a
a
o
a
o
a
o
a
a
a
a
a
a
a
o
a
a
o
a
a
o
a
o
a
a
a
a
a
a
a
a
a
a
a
G
a
a
a
G
a
G
a
a
a
G
a
a
a
a
a
G
a
G
a
G
a
a
a
G
a
a
a
Y
a
a
a
k
a
a
a
Y
a
o
a
Y
a
o
a
a
a
o
"}
(7,1,1) = {"
o
o
a
a
a
a
a
a
a
a
a
a
a
o
o
o
o
o
c
a
a
a
a
o
o
a
a
a
a
a
o
a
o
o
o
o
o
a
o
o
o
o
o
o
o
o
o
a
o
o
o
o
o
o
o
a
o
a
a
a
a
a
a
a
G
a
a
a
G
a
a
a
G
a
G
a
a
a
G
a
a
a
a
a
G
a
G
G
G
G
G
G
G
a
a
a
G
G
a
a
a
a
a
G
o
a
o
a
o
o
o
Y
o
o
o
"}
(8,1,1) = {"
o
o
a
a
a
a
a
a
a
a
a
a
a
o
o
o
a
a
a
a
a
a
a
a
o
a
a
a
a
a
o
a
a
a
a
a
o
a
o
a
a
a
a
a
a
a
o
a
o
a
o
a
a
a
a
a
a
a
a
a
a
a
a
a
G
a
a
a
G
a
a
a
G
a
G
a
a
a
G
a
a
a
a
a
G
a
a
a
a
a
a
a
G
a
a
a
G
G
G
a
a
a
G
G
o
a
o
H
o
V
o
a
a
a
o
"}
(9,1,1) = {"
o
o
a
a
a
a
a
a
a
a
a
a
a
a
a
a
a
a
a
a
g
a
a
a
a
a
a
a
a
a
o
o
o
a
a
a
o
a
o
a
a
a
a
a
o
a
o
a
o
a
o
a
a
a
o
o
o
o
o
o
o
o
o
a
G
a
G
G
G
a
G
G
G
a
G
a
a
a
G
a
a
a
a
a
G
a
G
G
G
G
G
a
G
G
G
G
G
G
G
Y
G
G
G
G
o
a
o
a
o
z
o
a
P
a
o
"}
(10,1,1) = {"
o
o
a
a
a
a
a
a
a
a
a
a
a
o
o
o
a
a
a
a
a
a
a
a
o
a
a
a
a
a
a
a
o
a
a
a
o
a
o
a
a
a
a
a
a
a
o
a
o
a
o
a
a
a
o
a
a
a
a
a
a
a
a
a
G
a
G
G
G
a
G
a
a
a
G
a
a
a
G
a
a
a
a
a
G
a
G
a
a
a
G
a
G
a
a
a
a
a
a
a
G
a
a
a
o
a
o
a
o
a
Y
a
a
a
o
"}
(11,1,1) = {"
o
o
a
a
a
a
a
a
a
a
a
a
a
o
o
o
o
o
c
a
a
a
a
o
o
a
a
a
a
a
o
a
o
a
a
a
o
a
o
a
a
a
a
a
o
o
o
a
o
a
o
a
a
a
o
a
o
o
o
o
o
o
o
o
o
a
G
G
G
a
G
a
a
a
G
a
a
a
G
a
a
a
a
a
G
a
G
a
a
a
G
a
G
a
a
a
a
a
a
a
G
a
a
a
o
a
o
a
o
o
o
o
o
o
o
"}
(12,1,1) = {"
o
o
a
o
o
a
a
a
a
a
o
o
a
o
o
o
o
o
o
a
a
a
o
o
o
a
a
a
a
a
o
a
o
a
a
a
o
a
o
a
a
a
a
a
o
a
a
a
a
a
o
a
a
a
o
a
a
a
a
a
a
a
a
a
a
a
G
G
G
a
G
a
a
a
G
a
a
a
G
a
a
a
a
a
G
a
a
a
a
a
G
a
G
a
a
a
a
a
a
a
G
a
a
a
o
a
o
a
o
o
l
a
r
o
o
"}
(13,1,1) = {"
o
o
a
a
o
a
a
a
a
a
o
a
a
o
o
o
o
o
o
o
o
o
o
o
o
o
o
o
o
a
o
a
o
a
a
a
o
a
o
a
a
a
a
a
o
a
a
a
o
a
o
a
a
a
o
o
o
o
o
a
a
a
a
a
a
a
G
G
G
a
G
a
a
a
G
a
a
a
G
G
G
G
G
G
G
G
G
G
G
G
G
a
G
a
a
a
a
a
a
a
G
a
a
a
o
a
o
a
o
a
a
a
a
a
o
"}
(14,1,1) = {"
o
o
a
a
a
a
a
a
a
a
a
a
a
o
o
o
o
o
o
o
o
o
o
o
o
o
o
a
a
a
o
a
o
a
a
a
o
a
a
a
a
a
a
a
a
a
a
a
o
a
o
a
a
a
a
a
a
a
o
a
a
a
a
a
a
a
G
G
G
a
G
a
a
a
a
a
a
a
G
a
a
a
G
G
a
a
a
G
G
a
a
a
G
a
a
a
a
a
a
a
Y
a
a
a
o
a
o
a
Y
a
a
c
a
a
o
"}
(15,1,1) = {"
o
o
o
o
o
o
o
o
o
o
o
o
o
o
o
o
o
o
o
o
o
o
o
o
o
o
o
a
a
a
o
a
o
o
o
a
o
o
o
o
o
o
o
o
o
o
o
o
o
o
o
o
o
o
o
o
o
a
o
a
a
a
a
a
a
a
G
G
G
a
G
a
a
a
G
a
a
a
G
a
G
a
G
a
a
a
a
a
G
a
G
G
G
G
G
G
G
G
G
G
G
a
a
a
o
o
o
a
o
a
I
a
a
a
o
"}
(16,1,1) = {"
o
o
o
o
o
o
o
o
o
o
o
o
o
o
o
o
o
o
o
o
o
o
o
o
o
o
o
a
a
a
o
a
a
a
a
a
a
a
a
a
a
o
o
a
a
a
o
a
a
a
a
a
a
a
a
a
a
a
o
a
a
a
a
a
a
a
G
a
a
a
G
a
a
a
G
a
a
a
G
a
G
a
a
a
a
c
a
a
G
a
a
a
a
a
a
a
a
a
a
a
G
a
a
a
Y
a
o
a
o
o
a
a
a
o
o
"}
(17,1,1) = {"
o
o
o
o
o
o
o
o
o
o
o
o
o
o
o
o
o
o
o
o
o
o
o
o
o
o
o
a
o
o
o
o
o
o
o
o
o
o
o
o
a
o
o
a
a
a
o
a
o
a
a
a
a
a
o
o
o
o
o
a
o
a
o
o
o
o
G
a
G
G
G
G
o
o
o
a
G
G
G
a
G
a
G
a
a
a
a
a
G
a
a
a
a
a
a
a
a
a
a
a
G
a
o
o
o
a
o
a
o
o
o
a
o
o
o
"}
(18,1,1) = {"
o
o
o
o
o
o
o
o
o
o
o
o
o
o
o
o
o
o
o
o
o
o
o
o
o
o
o
a
a
a
o
a
a
a
a
a
a
o
o
o
a
o
o
a
a
a
a
a
o
a
a
a
a
a
o
a
a
a
a
a
o
a
a
a
o
a
a
a
G
a
a
a
a
a
a
a
o
a
a
a
G
a
G
G
a
a
a
G
G
a
a
a
a
a
a
a
a
a
a
a
G
a
a
a
o
H
o
a
o
o
o
a
a
a
o
"}
(19,1,1) = {"
o
o
o
o
o
o
o
o
o
o
o
o
o
o
o
o
o
o
o
o
o
o
o
o
o
o
o
a
a
a
o
a
a
a
a
a
a
o
o
a
a
a
o
o
o
o
o
o
o
a
a
a
a
a
o
a
a
a
a
a
o
a
o
o
o
a
G
G
G
a
a
a
a
a
a
a
o
a
G
a
G
G
G
G
G
a
G
G
G
G
G
G
G
G
G
G
G
G
G
a
G
a
a
a
o
a
o
a
o
o
o
o
o
a
o
"}
(20,1,1) = {"
o
o
o
o
o
o
o
o
o
o
o
o
o
o
o
o
o
o
o
o
o
o
o
o
o
o
o
a
a
a
o
a
a
a
a
a
a
o
a
a
a
a
a
o
a
a
a
a
o
a
a
a
a
a
a
a
a
a
a
a
Q
a
a
a
a
a
G
G
G
a
a
a
a
a
a
a
o
a
G
a
G
a
a
a
a
a
a
a
G
a
a
a
a
a
a
a
G
G
G
a
G
a
a
a
o
a
a
a
o
a
a
a
a
a
o
"}
(21,1,1) = {"
o
o
o
o
o
o
o
o
o
o
o
o
o
o
o
o
o
o
o
o
o
o
o
o
o
o
o
a
a
a
o
a
a
a
a
a
a
a
a
a
c
a
a
a
a
o
o
a
o
o
o
o
o
o
o
o
o
o
o
o
o
o
o
o
o
a
G
G
G
a
G
G
o
o
o
a
o
a
G
a
G
a
a
a
a
a
a
a
G
a
a
a
a
a
a
a
G
G
G
a
G
a
a
a
o
o
o
o
o
a
D
a
a
a
o
"}
(22,1,1) = {"
o
o
o
o
o
o
o
o
o
o
o
o
o
o
o
o
o
o
o
o
o
o
o
o
o
o
o
a
a
a
a
a
a
a
a
a
a
o
a
a
a
a
a
o
o
a
a
a
o
a
a
a
a
a
a
a
a
a
a
a
t
a
a
a
o
a
a
a
a
a
a
a
o
a
a
a
a
a
G
a
G
a
a
a
a
a
a
a
a
a
a
a
a
a
a
a
a
a
a
a
G
a
a
a
o
o
o
o
o
a
a
a
a
a
o
"}
(23,1,1) = {"
o
o
o
o
o
o
o
o
o
o
o
o
o
o
o
o
o
o
o
o
o
o
o
o
o
o
o
o
o
o
o
a
a
a
a
a
a
o
o
a
a
a
o
o
o
a
o
o
o
U
U
U
U
U
U
U
U
U
U
U
U
U
U
U
G
G
G
G
G
a
a
a
o
a
a
a
a
a
G
a
G
G
G
a
G
G
G
G
G
a
a
a
a
a
a
a
G
G
G
G
G
Y
G
G
o
o
o
o
o
o
o
o
o
o
o
"}
(24,1,1) = {"
o
o
o
o
o
o
o
o
o
o
o
o
o
o
o
o
o
o
o
o
o
o
o
o
o
o
o
o
o
o
o
a
a
a
a
a
a
o
o
o
o
o
o
o
o
a
a
a
v
S
S
S
S
S
S
S
S
S
S
S
S
S
S
S
s
a
a
a
a
a
a
a
a
a
a
a
a
a
G
a
a
a
G
a
a
a
a
a
a
a
a
a
a
a
a
a
G
a
a
a
a
a
a
a
a
a
a
a
a
a
a
a
a
a
o
"}
(25,1,1) = {"
o
o
o
o
o
o
o
o
o
o
o
o
o
o
o
o
o
o
o
o
o
o
o
o
o
o
o
o
o
o
o
o
o
o
o
o
o
o
o
o
o
o
o
o
o
o
o
o
o
o
o
o
o
o
o
o
o
o
o
o
o
o
o
o
o
o
o
o
o
o
o
o
o
o
o
o
o
o
o
o
o
o
o
o
o
o
o
o
o
o
o
o
o
o
o
o
o
o
o
o
o
o
o
o
o
o
o
o
o
o
o
o
o
o
o
"}
