//MAP CONVERTED BY dmm2tgm.py THIS HEADER COMMENT PREVENTS RECONVERSION, DO NOT REMOVE
"a" = (
/turf/open/indestructible{
	icon_state = "stone_floor";
	name = "Dungeon Floor"
	},
/area/space)
"c" = (
/obj/structure/bonfire/prelit,
/turf/open/indestructible{
	icon_state = "stone_floor";
	name = "Dungeon Floor"
	},
/area/space)
"g" = (
/obj/structure/healingfountain,
/turf/open/indestructible{
	icon_state = "stone_floor";
	name = "Dungeon Floor"
	},
/area/space)
"i" = (
/mob/living/simple_animal/hostile/retaliate/bat{
	combat_mode = 1;
	name = "Dungeon Bat"
	},
/turf/open/indestructible{
	icon_state = "stone_floor";
	name = "Dungeon Floor"
	},
/area/space)
"l" = (
/obj/item/flashlight/flare/torch,
/turf/open/indestructible{
	icon_state = "stone_floor";
	name = "Dungeon Floor"
	},
/area/space)
"o" = (
/turf/closed/indestructible/iron{
	name = "dungeon wall"
	},
/area/space)
"r" = (
/obj/item/claymore,
/turf/open/indestructible{
	icon_state = "stone_floor";
	name = "Dungeon Floor"
	},
/area/space)
"s" = (
/obj/structure/railing/corner{
	dir = 1
	},
/turf/open/indestructible{
	icon_state = "stone_floor";
	name = "Dungeon Floor"
	},
/area/space)
"t" = (
/obj/machinery/power/emitter/energycannon{
	name = "Dart Trap";
	desc = "A hidden dart trap that is imbeded in the dungeon wall.";
	machine_power_rectifier = 0;
	circuit = null;
	projectile_sound = 'sound/weapons/tap.ogg';
	maximum_fire_delay = 20;
	projectile_type = /obj/projectile/bullet/dart;
	payment_department = null
	},
/turf/open/indestructible{
	icon_state = "stone_floor";
	name = "Dungeon Floor"
	},
/area/space)
"v" = (
/obj/structure/railing/corner{
	dir = 8
	},
/turf/open/indestructible{
	icon_state = "stone_floor";
	name = "Dungeon Floor"
	},
/area/space)
"x" = (
/obj/structure/mineral_door/iron{
	icon = 'icons/obj/doors/airlocks/station/freezer.dmi';
	icon_state = "closed";
	name = "dungeon door";
	sheetType = null;
	sheetAmount = null;
	light_color = "#808080";
	uses_integrity = 0
	},
/turf/open/indestructible{
	icon_state = "stone_floor";
	name = "Dungeon Floor"
	},
/area/space)
"z" = (
/obj/item/food/cheese/wedge,
/turf/open/indestructible{
	icon_state = "stone_floor";
	name = "Dungeon Floor"
	},
/area/space)
"D" = (
/obj/machinery/gateway/away,
/turf/open/indestructible{
	icon_state = "stone_floor";
	name = "Dungeon Floor"
	},
/area/space)
"H" = (
/mob/living/simple_animal/hostile/rat{
	combat_mode = 1;
	name = "dungeon rat"
	},
/turf/open/indestructible{
	icon_state = "stone_floor";
	name = "Dungeon Floor"
	},
/area/space)
"P" = (
/mob/living/simple_animal/hostile/regalrat,
/turf/open/indestructible{
	icon_state = "stone_floor";
	name = "Dungeon Floor"
	},
/area/space)
"S" = (
/obj/structure/railing{
	dir = 8
	},
/turf/open/indestructible{
	icon_state = "stone_floor";
	name = "Dungeon Floor"
	},
/area/space)
"U" = (
/turf/open/chasm,
/area/space)
"V" = (
/obj/item/food/cheese/wheel,
/obj/item/knife/kitchen,
/turf/open/indestructible{
	icon_state = "stone_floor";
	name = "Dungeon Floor"
	},
/area/space)

(1,1,1) = {"
o
o
o
o
o
o
o
o
o
o
o
o
o
o
o
o
o
o
o
o
o
o
o
o
o
o
o
o
o
o
o
o
o
o
o
o
o
o
o
o
o
o
o
o
o
o
o
o
o
o
o
o
o
o
o
o
o
o
o
o
o
o
o
o
o
o
o
o
o
o
o
o
o
o
o
o
o
o
o
o
o
o
o
o
o
o
o
o
o
o
o
o
o
o
o
o
o
o
o
o
o
o
o
o
o
o
o
o
o
o
o
o
o
o
o
"}
(2,1,1) = {"
o
o
o
o
o
o
o
o
o
o
o
o
o
o
o
o
o
o
o
o
o
o
o
o
o
o
o
a
a
a
o
a
a
a
o
a
a
a
a
a
a
a
a
a
o
a
a
a
o
a
a
o
a
a
o
a
o
a
a
a
a
a
a
a
a
a
a
a
a
a
o
a
a
a
a
a
a
a
a
a
a
a
a
a
a
a
a
a
a
a
a
a
a
a
a
a
o
o
o
a
i
a
o
o
o
a
a
a
o
a
H
a
H
a
o
"}
(3,1,1) = {"
o
o
o
o
o
o
o
o
o
o
o
o
o
o
o
o
o
o
o
o
o
o
o
o
o
o
o
a
o
a
o
a
o
a
o
a
o
a
o
a
o
o
o
o
o
a
a
a
o
o
a
a
a
o
o
a
o
a
a
a
a
a
a
a
o
o
o
o
o
a
o
a
o
a
o
o
o
o
o
a
a
a
a
a
o
a
o
a
o
o
o
o
o
o
o
a
o
o
i
a
a
a
i
o
o
a
o
a
o
a
a
x
a
a
o
"}
(4,1,1) = {"
o
o
a
a
a
a
a
a
a
a
a
a
a
o
o
o
o
o
o
o
o
o
o
o
o
o
o
a
o
a
a
a
o
a
o
a
o
a
o
a
o
a
a
a
a
a
a
a
a
a
a
a
a
a
a
a
o
a
a
a
a
a
a
a
o
o
o
o
o
a
a
a
o
a
o
a
a
a
o
a
a
a
a
a
o
a
o
a
o
a
a
a
a
a
o
a
a
a
a
a
i
a
a
a
a
a
o
a
o
H
a
H
a
H
o
"}
(5,1,1) = {"
o
o
a
a
o
a
a
a
a
a
o
a
a
o
o
o
o
o
o
o
o
o
o
o
o
o
o
a
o
o
o
a
o
a
o
a
o
a
o
a
o
a
a
a
o
o
o
o
o
o
a
a
a
o
o
a
o
a
a
a
a
a
a
a
o
o
o
o
o
a
a
a
o
a
o
a
a
a
o
a
a
a
a
a
o
a
o
a
o
a
a
a
o
a
o
o
o
i
a
i
a
i
a
i
o
o
o
a
o
a
o
o
o
a
o
"}
(6,1,1) = {"
o
o
a
o
o
a
a
a
a
a
o
o
a
o
o
o
o
o
o
a
a
a
o
o
o
a
a
a
a
a
o
a
o
a
a
a
o
a
o
a
o
a
a
a
a
a
a
a
o
a
a
o
a
a
o
a
o
a
a
a
a
a
a
a
a
a
a
a
o
a
a
a
o
a
o
a
a
a
o
a
a
a
a
a
o
a
o
a
o
a
a
a
o
a
a
a
a
a
a
a
i
a
a
a
a
a
o
a
a
a
o
a
H
a
o
"}
(7,1,1) = {"
o
o
a
a
a
a
a
a
a
a
a
a
a
o
o
o
o
o
c
a
a
a
a
o
o
a
a
a
a
a
o
a
o
o
o
o
o
a
o
o
o
o
o
o
o
o
o
a
o
o
o
o
o
o
o
a
o
a
a
a
a
a
a
a
o
a
a
a
o
a
a
a
o
a
o
a
a
a
o
a
a
a
a
a
o
a
o
o
o
o
o
o
o
a
a
a
o
o
i
a
a
a
i
o
o
a
o
a
o
o
o
a
o
o
o
"}
(8,1,1) = {"
o
o
a
a
a
a
a
a
a
a
a
a
a
o
o
o
a
a
a
a
a
a
a
a
o
a
a
a
a
a
o
a
a
a
a
a
o
a
o
a
a
a
a
a
a
a
o
a
o
a
o
a
a
a
a
a
a
a
a
a
a
a
a
a
o
a
a
a
o
a
a
a
o
a
o
a
a
a
o
a
a
a
a
a
o
a
a
a
a
a
a
a
o
a
a
a
o
o
o
a
i
a
o
o
o
a
o
a
o
V
o
a
a
a
o
"}
(9,1,1) = {"
o
o
a
a
a
a
a
a
a
a
a
a
a
a
a
a
a
a
a
a
g
a
a
a
a
a
a
a
a
a
o
o
o
a
a
a
o
a
o
a
a
a
a
a
o
a
o
a
o
a
o
a
a
a
o
o
o
o
o
o
o
o
o
a
o
a
o
o
o
a
o
o
o
a
o
a
a
a
o
a
a
a
a
a
o
a
o
o
o
o
o
a
o
o
o
o
o
o
o
a
o
o
o
o
o
a
o
a
o
z
o
H
P
H
o
"}
(10,1,1) = {"
o
o
a
a
a
a
a
a
a
a
a
a
a
o
o
o
a
a
a
a
a
a
a
a
o
a
a
a
a
a
a
a
o
a
a
a
o
a
o
a
a
a
a
a
a
a
o
a
o
a
o
a
a
a
o
a
a
a
a
a
a
a
a
a
o
a
o
o
o
a
o
a
a
a
o
a
a
a
o
a
a
a
a
a
o
a
o
a
a
a
o
a
o
a
a
a
a
a
a
a
o
a
a
a
o
a
o
a
o
a
a
H
H
H
o
"}
(11,1,1) = {"
o
o
a
a
a
a
a
a
a
a
a
a
a
o
o
o
o
o
c
a
a
a
a
o
o
a
a
a
a
a
o
a
o
a
a
a
o
a
o
a
a
a
a
a
o
o
o
a
o
a
o
a
a
a
o
a
o
o
o
o
o
o
o
o
o
a
o
o
o
a
o
a
a
a
o
a
a
a
o
a
a
a
a
a
o
a
o
a
a
a
o
a
o
a
a
a
a
a
a
a
o
a
a
a
o
a
o
a
o
o
o
o
o
o
o
"}
(12,1,1) = {"
o
o
a
o
o
a
a
a
a
a
o
o
a
o
o
o
o
o
o
a
a
a
o
o
o
a
a
a
a
a
o
a
o
a
a
a
o
a
o
a
a
a
a
a
o
a
a
a
a
a
o
a
a
a
o
a
a
a
a
a
a
a
a
a
a
a
o
o
o
a
o
a
a
a
o
a
a
a
o
a
a
a
a
a
o
a
a
a
a
a
o
a
o
a
a
a
a
a
a
a
o
a
a
a
o
a
o
a
o
o
l
a
r
o
o
"}
(13,1,1) = {"
o
o
a
a
o
a
a
a
a
a
o
a
a
o
o
o
o
o
o
o
o
o
o
o
o
o
o
o
o
a
o
a
o
a
a
a
o
a
o
a
a
a
a
a
o
a
a
a
o
a
o
a
a
a
o
o
o
o
o
a
a
a
a
a
a
a
o
o
o
a
o
a
a
a
o
a
a
a
o
o
o
o
o
o
o
o
o
o
o
o
o
a
o
a
a
a
a
a
a
a
o
a
a
a
o
a
o
a
o
a
a
a
a
a
o
"}
(14,1,1) = {"
o
o
a
a
a
a
a
a
a
a
a
a
a
o
o
o
o
o
o
o
o
o
o
o
o
o
o
a
a
a
o
a
o
a
a
a
o
a
a
a
a
a
a
a
a
a
a
a
o
a
o
a
a
a
a
a
a
a
o
a
a
a
a
a
a
a
o
o
o
a
o
a
a
a
a
a
a
a
o
a
a
a
o
o
a
a
a
o
o
a
a
a
o
a
a
a
a
a
a
a
a
a
a
a
o
a
o
a
a
a
a
c
a
a
o
"}
(15,1,1) = {"
o
o
o
o
o
o
o
o
o
o
o
o
o
o
o
o
o
o
o
o
o
o
o
o
o
o
o
a
a
a
o
a
o
o
o
a
o
o
o
o
o
o
o
o
o
o
o
o
o
o
o
o
o
o
o
o
o
a
o
a
a
a
a
a
a
a
o
o
o
a
o
a
a
a
o
a
a
a
o
a
o
a
o
a
a
a
a
a
o
a
o
o
o
o
o
o
o
o
o
o
o
a
a
a
o
o
o
a
o
a
a
a
a
a
o
"}
(16,1,1) = {"
o
o
o
o
o
o
o
o
o
o
o
o
o
o
o
o
o
o
o
o
o
o
o
o
o
o
o
a
a
a
o
a
a
a
a
a
a
a
a
a
a
o
o
a
a
a
o
a
a
a
a
a
a
a
a
a
a
a
o
a
a
a
a
a
a
a
o
a
a
a
o
a
a
a
o
a
a
a
o
a
o
a
a
a
a
c
a
a
o
a
a
a
a
a
a
a
a
a
a
a
o
a
a
a
a
a
o
a
o
o
a
a
a
o
o
"}
(17,1,1) = {"
o
o
o
o
o
o
o
o
o
o
o
o
o
o
o
o
o
o
o
o
o
o
o
o
o
o
o
a
o
o
o
o
o
o
o
o
o
o
o
o
a
o
o
a
a
a
o
a
o
a
a
a
a
a
o
o
o
o
o
a
o
a
o
o
o
o
o
a
o
o
o
o
o
o
o
a
o
o
o
a
o
a
o
a
a
a
a
a
o
a
a
a
a
a
a
a
a
a
a
a
o
a
o
o
o
a
o
a
o
o
o
a
o
o
o
"}
(18,1,1) = {"
o
o
o
o
o
o
o
o
o
o
o
o
o
o
o
o
o
o
o
o
o
o
o
o
o
o
o
a
a
a
o
a
a
a
a
a
a
o
o
o
a
o
o
a
a
a
a
a
o
a
a
a
a
a
o
a
a
a
a
a
o
a
a
a
o
a
a
a
o
a
a
a
a
a
a
a
o
a
a
a
o
a
o
o
a
a
a
o
o
a
a
a
a
a
a
a
a
a
a
a
o
a
a
a
o
a
o
a
o
o
o
a
a
a
o
"}
(19,1,1) = {"
o
o
o
o
o
o
o
o
o
o
o
o
o
o
o
o
o
o
o
o
o
o
o
o
o
o
o
a
a
a
o
a
a
a
a
a
a
o
o
a
a
a
o
o
o
o
o
o
o
a
a
a
a
a
o
a
a
a
a
a
o
a
o
o
o
a
o
o
o
a
a
a
a
a
a
a
o
a
o
a
o
o
o
o
o
a
o
o
o
o
o
o
o
o
o
o
o
o
o
a
o
a
a
a
o
a
o
a
o
o
o
o
o
a
o
"}
(20,1,1) = {"
o
o
o
o
o
o
o
o
o
o
o
o
o
o
o
o
o
o
o
o
o
o
o
o
o
o
o
a
a
a
o
a
a
a
a
a
a
o
a
a
a
a
a
o
a
a
a
a
o
a
a
a
a
a
a
a
a
a
a
a
o
a
a
a
a
a
o
o
o
a
a
a
a
a
a
a
o
a
o
a
o
a
a
a
a
a
a
a
o
a
a
a
a
a
a
a
o
o
o
a
o
a
a
a
o
a
a
a
o
a
a
a
a
a
o
"}
(21,1,1) = {"
o
o
o
o
o
o
o
o
o
o
o
o
o
o
o
o
o
o
o
o
o
o
o
o
o
o
o
a
a
a
o
a
a
a
a
a
a
a
a
a
c
a
a
a
a
o
o
a
o
o
o
o
o
o
o
o
o
o
o
o
o
o
o
o
o
a
o
o
o
a
o
o
o
o
o
a
o
a
o
a
o
a
a
a
a
a
a
a
o
a
a
a
a
a
a
a
o
o
o
a
o
a
a
a
o
o
o
o
o
a
D
a
a
a
o
"}
(22,1,1) = {"
o
o
o
o
o
o
o
o
o
o
o
o
o
o
o
o
o
o
o
o
o
o
o
o
o
o
o
a
a
a
a
a
a
a
a
a
a
o
a
a
a
a
a
o
o
a
a
a
o
a
a
a
a
a
a
a
a
a
a
a
t
a
a
a
o
a
a
a
a
a
a
a
o
a
a
a
a
a
o
a
o
a
a
a
a
a
a
a
a
a
a
a
a
a
a
a
a
a
a
a
o
a
a
a
o
o
o
o
o
a
a
a
a
a
o
"}
(23,1,1) = {"
o
o
o
o
o
o
o
o
o
o
o
o
o
o
o
o
o
o
o
o
o
o
o
o
o
o
o
o
o
o
o
a
a
a
a
a
a
o
o
a
a
a
o
o
o
a
o
o
o
U
U
U
U
U
U
U
U
U
U
U
U
U
U
U
o
o
o
o
o
a
a
a
o
a
a
a
a
a
o
a
o
o
o
a
o
o
o
o
o
a
a
a
a
a
a
a
o
o
o
o
o
a
o
o
o
o
o
o
o
o
o
o
o
o
o
"}
(24,1,1) = {"
o
o
o
o
o
o
o
o
o
o
o
o
o
o
o
o
o
o
o
o
o
o
o
o
o
o
o
o
o
o
o
a
a
a
a
a
a
o
o
o
o
o
o
o
o
a
a
a
v
S
S
S
S
S
S
S
S
S
S
S
S
S
S
S
s
a
a
a
a
a
a
a
a
a
a
a
a
a
o
a
a
a
o
a
a
a
a
a
a
a
a
a
a
a
a
a
o
a
a
a
a
a
a
a
a
a
a
a
a
a
a
a
a
a
o
"}
(25,1,1) = {"
o
o
o
o
o
o
o
o
o
o
o
o
o
o
o
o
o
o
o
o
o
o
o
o
o
o
o
o
o
o
o
o
o
o
o
o
o
o
o
o
o
o
o
o
o
o
o
o
o
o
o
o
o
o
o
o
o
o
o
o
o
o
o
o
o
o
o
o
o
o
o
o
o
o
o
o
o
o
o
o
o
o
o
o
o
o
o
o
o
o
o
o
o
o
o
o
o
o
o
o
o
o
o
o
o
o
o
o
o
o
o
o
o
o
o
"}
